0 1 2 3 4 1 5 6 
7 8 9 8 3 10 5 6 
7 11 8 2 9 9 5 6 
12 13 9 14 8 14 5 6 
15 16 17 18 17 19 17 6 
